0 0 0 0 0 0 0 0 0 L
0 0 0 0 0 0 0 0 A 0
0 0 X X 0 0 0 0 0 0
0 0 X X 0 0 0 0 0 0
0 0 X X X X X X 0 C
0 0 X X X X X X 0 0
T R 0 0 0 0 X X 0 0
S 0 0 0 0 0 X X 0 0
0 0 0 0 0 0 0 0 0 0
0 0 0 T 0 0 0 0 0 0